8 33 33 33 8 33 33 10 8 8 8 33 33 33 8 8
8 33 8 33 33 8 8 33 8 8 8 33 8 33 33 33
33 33 33 8 8 8 33 33 33 33 8 33 33 33 8 33
33 8 33 33 33 33 33 8 8 33 8 33 8 8 8 8
33 8 33 8 8 8 33 33 8 33 33 33 33 8 8 8
10 8 33 8 33 33 33 8 8 33 8 8 33 8 33 8
33 33 8 8 33 8 8 33 33 8 8 8 33 33 33 8
8 33 33 8 33 8 8 8 33 33 33 8 8 33 8 8
8 8 33 8 8 33 33 33 33 8 8 33 33 33 33 8
33 33 33 8 8 33 8 33 8 8 8 33 8 8 33 8
33 8 33 33 33 33 8 33 8 33 33 33 8 8 33 8
8 33 33 8 8 8 8 33 33 33 8 33 33 8 33 8