8 8 8 8 8 8 8 8 8 8 8 8 8 8 8 8
8 8 8 8 8 8 8 8 8 8 8 8 8 8 8 8
8 8 8 8 9 9 9 9 9 9 9 9 8 8 8 8
8 8 8 8 9 9 9 21 9 9 9 9 8 8 8 8
8 8 8 8 9 9 9 9 9 9 9 9 8 8 8 8
8 8 8 8 9 9 9 9 9 9 9 9 8 8 8 8
8 8 8 8 8 8 8 9 9 8 8 8 8 8 8 8
8 8 8 8 8 8 8 9 9 8 8 8 8 8 8 8
8 8 8 8 8 8 8 9 9 8 8 8 8 8 8 8
8 8 8 8 8 8 8 9 9 8 8 8 8 8 8 8
8 8 8 8 8 8 8 9 9 8 8 8 8 8 8 8
8 8 8 8 8 8 8 10 9 8 8 8 8 8 8 8