6 6 6 6 6 6 6 6 6 6 6 6 6 6 6 6
6 5 5 5 5 5 5 5 5 5 5 5 5 5 5 6
6 5 5 5 5 5 5 5 5 5 5 5 5 5 5 6
6 5 16 16 16 16 5 5 5 5 5 5 5 5 5 6
6 5 16 5 5 5 5 5 5 5 5 5 5 5 5 6
6 5 16 5 20 5 5 5 5 5 5 5 5 5 5 7
6 5 16 5 5 5 5 5 5 5 5 5 5 5 5 6
6 5 16 5 5 5 5 5 5 5 5 5 5 5 5 6
6 5 16 16 16 16 5 5 5 5 5 5 5 5 5 6
6 5 5 5 5 5 5 5 5 5 5 5 5 5 5 6
6 5 5 5 5 5 5 5 5 5 5 5 5 5 5 6
6 6 6 6 6 6 6 6 6 6 6 6 6 6 6 6