8 8 8 8 8 8 8 8 8 8 8 8 8 8 8 8
8 8 8 8 8 8 8 8 8 8 8 8 8 8 8 8
8 8 8 8 8 8 8 8 8 8 8 8 8 8 8 8
0 0 0 0 0 0 0 0 0 0 0 0 0 8 8 8
0 0 0 0 14 0 0 0 0 0 0 0 0 8 8 8
1 0 0 0 0 0 0 0 0 0 0 0 0 8 8 10
0 0 0 0 0 0 0 0 0 0 0 0 0 8 8 8
0 0 0 0 0 0 0 0 0 0 0 0 0 8 8 8
0 0 0 0 0 0 0 0 0 0 0 0 14 8 8 8
0 0 0 0 0 0 0 8 8 8 8 8 8 8 8 8
0 0 0 0 8 8 8 8 8 8 8 8 8 8 8 8
0 8 8 8 8 8 8 8 8 8 8 8 8 8 8 8