11 11 11 11 11 11 11 12 11 11 11 11 11 11 11 11
15 11 11 11 23 11 11 11 11 11 11 11 11 11 11 11
11 11 11 11 11 11 11 11 11 11 23 11 11 15 11 11
11 11 15 11 11 11 11 11 11 11 11 11 11 11 11 11
11 11 11 11 11 11 11 11 11 11 11 15 11 11 11 11
11 11 11 11 11 11 11 11 11 11 11 11 11 11 11 11
11 11 11 11 11 15 11 11 11 15 11 11 11 11 11 15
11 11 11 11 11 11 11 11 11 11 11 11 11 11 11 11
11 15 11 11 11 11 11 11 23 11 11 11 11 11 11 11
11 11 11 23 11 11 11 11 11 11 11 11 15 11 11 11
11 11 11 11 11 11 11 11 11 11 11 11 11 11 11 11
11 11 11 11 11 11 11 12 11 11 11 11 11 11 11 11