0 0 0 0 0 0 0 0 0 0 0 0 0 0 0 0
5 0 0 0 0 0 0 0 0 0 0 0 0 14 0 0
5 5 5 0 0 0 0 14 0 0 0 0 0 0 0 0
5 5 5 5 5 0 0 0 0 0 0 0 0 0 0 0
6 6 5 5 0 0 0 0 0 0 0 0 0 0 0 0
7 6 5 5 0 0 0 0 0 0 0 0 0 0 0 1
6 6 5 5 0 0 0 0 0 0 0 0 0 0 0 0
5 5 5 5 5 0 0 0 0 0 0 0 0 0 0 0
5 5 5 5 5 5 0 0 0 0 0 0 0 0 0 0
5 6 5 5 5 0 0 0 0 0 0 0 0 0 0 0
5 6 5 5 0 0 0 0 0 0 14 0 0 0 0 0
5 5 5 5 0 14 0 0 0 0 0 0 0 0 0 0