11 11 11 11 11 11 11 11 11 11 11 11 11 11 23 11
11 15 11 23 11 11 11 11 11 11 11 11 11 11 11 11
11 11 11 11 11 15 11 11 11 11 11 11 11 11 15 11
11 11 11 11 11 11 23 11 23 11 15 11 11 11 11 11
11 11 11 11 11 11 11 22 11 11 11 11 11 11 11 11
11 11 15 11 11 11 23 11 23 11 11 11 11 11 11 11
11 11 11 11 11 11 11 11 11 11 11 11 11 11 11 11
11 23 11 11 11 11 11 11 11 11 11 11 11 15 11 11
11 11 11 11 11 11 11 11 11 11 11 11 11 11 11 11
11 11 11 11 11 15 11 11 11 11 11 15 11 11 11 11
11 15 11 11 23 11 11 11 11 11 11 11 11 11 23 11
11 11 11 11 11 11 11 12 11 11 11 11 11 11 11 11