8 8 8 8 8 8 8 8 8 8 8 8 8 8 8 8
8 8 8 8 8 8 8 8 8 8 8 8 8 8 8 8
8 8 33 33 33 33 8 8 8 33 33 33 33 33 8 8
8 8 33 8 33 33 8 8 8 33 33 33 8 33 8 8
8 8 33 33 33 33 8 8 8 33 33 8 8 33 8 8
10 9 33 33 33 33 33 33 33 33 33 8 8 33 9 10
8 8 9 8 33 33 8 8 8 8 8 8 8 33 8 8
8 8 9 8 8 33 8 8 33 33 33 8 8 33 8 8
8 8 9 8 8 33 33 33 33 8 33 33 33 33 8 8
8 8 8 8 8 8 33 33 8 8 8 8 8 8 8 8
8 8 8 8 8 8 8 8 8 8 8 8 8 8 8 8
8 8 8 8 8 8 8 8 8 8 8 8 8 8 8 8