2 2 2 2 2 2 2 4 2 2 2 2 2 2 2 2
2 3 2 2 2 2 2 3 2 2 2 2 2 3 2 2
2 2 2 2 2 2 2 3 2 2 2 2 2 2 2 2
2 2 2 2 2 2 2 3 2 2 2 2 2 2 2 2
2 2 2 2 2 2 2 3 2 2 2 2 2 2 2 2
2 2 3 3 17 3 3 3 3 3 3 3 3 3 3 4
2 2 3 2 2 2 2 3 2 2 2 2 2 2 2 2
2 2 3 2 2 2 2 3 2 2 2 2 2 2 2 2
2 2 3 2 2 2 2 3 2 2 2 2 2 2 2 2
2 2 3 3 3 3 17 3 2 2 2 2 2 2 2 2
2 2 2 2 2 2 2 2 2 2 2 2 3 2 2 2
3 2 2 2 2 2 2 2 2 2 2 2 2 2 2 2