11 11 11 11 11 23 23 12 23 23 11 11 11 11 11 11
11 15 11 11 11 11 23 23 23 11 11 11 23 11 11 11
11 11 11 23 11 11 11 11 11 11 11 11 11 11 15 11
11 11 11 11 15 11 11 11 11 11 11 11 11 11 11 11
11 11 11 11 11 11 11 11 11 11 11 11 11 11 11 11
11 0 0 11 11 0 0 11 11 11 0 0 0 0 11 0
0 0 0 0 0 0 0 0 11 0 0 0 0 0 0 0
0 0 0 0 0 0 0 0 0 0 0 0 0 0 0 0
0 14 0 0 0 0 0 0 0 0 0 0 0 0 0 0
0 0 0 0 0 0 0 0 0 0 0 0 0 0 0 0
0 0 0 0 0 0 0 0 0 0 0 0 0 14 0 0
0 0 0 14 0 0 0 1 0 0 0 0 0 0 0 0